{
  "schemaVersion": 1,
  "tileSize": 32,
  "width": 181,
  "height": 24,
  "spawn": {
    "x": 90,
    "y": 12
  },
  "tiles": [
    "#####################################################################################################################################################################################",
    "#...................................................................................................................................................................................#",
    "#...................................................................................................................................................................................#",
    "#...................................................................................................................................................................................#",
    "#...................................................................................................................................................................................#",
    "#...................................................................................................................................................................................#",
    "#...................................................................................................................................................................................#",
    "#...................................................................................................................................................................................#",
    "#...................................................................................................................................................................................#",
    "#...................................................................................................................................................................................#",
    "#...................................................................................................................................................................................#",
    "#...................................................................................................................................................................................#",
    "#...................................................................................................................................................................................#",
    "#...................................................................................................................................................................................#",
    "#...................................................................................................................................................................................#",
    "#...................................................................................................................................................................................#",
    "#...................................................................................................................................................................................#",
    "#...................................................................................................................................................................................#",
    "#...................................................................................................................................................................................#",
    "#...................................................................................................................................................................................#",
    "#...................................................................................................................................................................................#",
    "#...................................................................................................................................................................................#",
    "#...................................................................................................................................................................................#",
    "#####################################################################################################################################################################################"
  ],
  "regions": [],
  "enemies": [],
  "elevatorPaths": [],
  "elevators": [],
  "pixelArt": {
    "tiles": {}
  },
  "musicZones": [],
  "midiTracks": [],
  "triggers": [],
  "decals": []
}