{
  "schemaVersion": 1,
  "tileSize": 32,
  "width": 58,
  "height": 28,
  "spawn": {
    "x": 37,
    "y": 21
  },
  "tiles": [
    "..............############################################",
    "..............############################################",
    "..............############################################",
    "...............###########################################",
    "...............###########################################",
    "...............###########################################",
    "...............######.................................####",
    "...............######.................................####",
    "...............######.................................####",
    "...............######.................................####",
    "...............######.................................####",
    "...............######.................................####",
    "...............######.................................####",
    "...............######.................................####",
    "...............######.................................####",
    "...............######.................................####",
    "...............######.................................####",
    "...............######.................................####",
    "...............######.................................####",
    "...............######.................................####",
    "...............######.................................####",
    "...............######.................................####",
    "...............######..............#####..............####",
    "...............###########################################",
    "..........##.#.###########################################",
    "##.#..#........###########################################",
    "...............###########################################",
    "...............###########################################"
  ],
  "regions": [],
  "enemies": [],
  "elevatorPaths": [],
  "elevators": [],
  "pixelArt": {
    "tiles": {}
  },
  "musicZones": [],
  "midiTracks": [
    {
      "id": "ambient-rift",
      "name": "Ambient Rift",
      "instrument": "piano",
      "notes": []
    },
    {
      "id": "industrial-hum",
      "name": "Industrial Hum",
      "instrument": "piano",
      "notes": []
    },
    {
      "id": "glacier-drift",
      "name": "Glacier Drift",
      "instrument": "piano",
      "notes": []
    },
    {
      "id": "boss-surge",
      "name": "Boss Surge",
      "instrument": "piano",
      "notes": []
    }
  ],
  "triggers": [],
  "decals": []
}