{
  "tileSize": 32,
  "width": 64,
  "height": 36,
  "tiles": [
    "################################################################",
    "#..............................................................#",
    "#..............................................................#",
    "#..............................................................#",
    "#..............................................................#",
    "#..............................................................#",
    "#.........................##a##................................#",
    "#..............................................................#",
    "#.......................................######.................#",
    "#...........................m.................#.........B......#",
    "#.......................#################.....##################",
    "#...............................#..............................#",
    "#...........................a...#...a..........................#",
    "#...............................#..............................#",
    "#...............................M..............................#",
    "#...............................#..............................#",
    "#.....#######...................#.................#######......#",
    "#...............................#..............................#",
    "#.................##G###........#.......####P#.................#",
    "#.....g.S...................S.$.#...S...............$.p........#",
    "#.#################.....#################.....##################",
    "#...............................#..............................#",
    "#...............................#..............................#",
    "#...............................#..............................#",
    "#...............................#..............................#",
    "#...............................#..............................#",
    "#...............................R.#####........................#",
    "#...............................#..............................#",
    "#...............................#..............................#",
    "#...........................r...#..............................#",
    "#.......................#################......................#",
    "#..............................................................#",
    "#..............................................................#",
    "#..............................................................#",
    "#..............................................................#",
    "################################################################"
  ],
  "regions": [
    {
      "id": "hub",
      "name": "Hub",
      "rect": [
        24,
        16,
        17,
        6
      ]
    },
    {
      "id": "tangle",
      "name": "Tangle",
      "rect": [
        2,
        16,
        17,
        6
      ]
    },
    {
      "id": "foundry",
      "name": "Foundry",
      "rect": [
        46,
        16,
        17,
        6
      ]
    },
    {
      "id": "spire",
      "name": "Spire",
      "rect": [
        24,
        6,
        17,
        6
      ]
    },
    {
      "id": "hollow",
      "name": "Hollow",
      "rect": [
        24,
        26,
        17,
        6
      ]
    },
    {
      "id": "rift",
      "name": "Rift",
      "rect": [
        46,
        6,
        17,
        6
      ]
    }
  ]
}