{
  "tileSize": 32,
  "width": 64,
  "height": 36,
  "tiles": [
    "################################################################",
    "################################################################",
    "################################################################",
    "################################################################",
    "################################################################",
    "################################################################",
    "#######################...................###.................##",
    "#######################...................###.................##",
    "#######################...................###.................##",
    "#######################.......S...H.................S.....B...##",
    "#######################....############...###.................##",
    "#######################.....a.......a.....###.................##",
    "#######################...m...............###.................##",
    "################################a###################.###########",
    "################################P###################R###########",
    "################################.###################.###########",
    "##.................####.......##.##.......###.......#####.....##",
    "##............a.a..####...................###...a.............##",
    "##........................#....##..................####.......##",
    "##....g...S.......H..........S......$...p..G......S.....$.....##",
    "#######################.....#.#...#...#.#.###.#.#.#.#...#.#.#.##",
    "##.................####...................###.................##",
    "##.................####...................###.................##",
    "################################.###############################",
    "################################M###############################",
    "################################.###############################",
    "#######################...................######################",
    "#######################...r...H...........######################",
    "#######################...#############...######################",
    "#######################.......S...........######################",
    "#######################...................######################",
    "#######################...................######################",
    "#######################...................######################",
    "################################################################",
    "################################################################",
    "################################################################"
  ],
  "regions": [
    {
      "id": "hub",
      "name": "Hub",
      "rect": [
        22,
        15,
        20,
        8
      ]
    },
    {
      "id": "tangle",
      "name": "Tangle",
      "rect": [
        1,
        15,
        18,
        8
      ]
    },
    {
      "id": "foundry",
      "name": "Foundry",
      "rect": [
        44,
        15,
        18,
        8
      ]
    },
    {
      "id": "spire",
      "name": "Spire",
      "rect": [
        22,
        5,
        20,
        8
      ]
    },
    {
      "id": "hollow",
      "name": "Hollow",
      "rect": [
        22,
        25,
        20,
        8
      ]
    },
    {
      "id": "rift",
      "name": "Rift",
      "rect": [
        44,
        5,
        18,
        8
      ]
    }
  ]
}
